F 200,0 , 200
C 99, 99, 99


NO ../texters/pa.xpm
SO ../texters/bbbbb.xpm
EA ../texters/img0.xpm
WE ../texters/pa.xpm
DO ../texters/door.xpm

11111111111111111111111111111111111111111
10000000000011D10000000000000000000000001
10000001111010000011111000000111100011111
10000000000000000000000000000000000000001
10000001111000000011111000000111100011111
1000000000001D100000000000000000000000001
100000011110000N0011111000000111100011111
10000000000000000000000000000000000000001
11000001111000000011111000000111100011111
11111111111111111111111111111111111111111
